*****XX****X********XXXX
XX******XX***XXXXX**XX**
XX***XXXX**XXXXX****XXXX
XX***XXXXXXXXXXXXXX****X
*****XXXXXX****XX***XXXX
XX*************XXXX*****
